######
#s   #
#CCCX#
#X   #
######
