#########
#       #
# CCSCC #
#   X   #
#  X X  #
#   X   #
#########
