    #    
   # #   
  #   #  
 #     #
#  X    #
# S#C   #
#       #
#########